10 10 0 0 
0 4 0 0 0 0 0 0 0 0
4 4 0 0 2 2 2 2 2 n
0 0 0 0 2 n 0 3 2 n
0 0 0 0 4 n 0 0 0 0
0 0 0 0 2 2 2 2 2 n
0 0 0 0 0 0 0 0 0 0
0 0 0 0 0 0 0 0 0 0
0 0 0 0 0 0 0 0 0 0
0 0 0 0 0 0 0 0 0 0
n 4 n 4 n 4 n 4 n 0
