20 10 0 0
0 2 1 4 0 4 1 0 0 0 0 0 1 1 4 1 1 0 0 3
4 1 5 1 1 1 1 1 1 1 1 0 1 4 1 4 1 0 1 1 
1 0 1 1 4 1 1 1 1 1 1 0 0 4 1 1 1 0 0 0 
1 0 1 1 0 1 1 1 4 1 1 1 1 1 1 0 1 1 1 0 
1 4 1 1 1 4 1 4 1 4 1 1 0 1 4 0 1 0 0 0 
1 1 0 0 1 4 0 1 0 0 1 1 4 2 4 1 1 0 1 1 
1 1 4 0 1 1 1 1 1 1 1 1 1 4 2 0 0 0 1 1 
1 0 4 1 1 1 5 1 4 1 1 4 0 0 2 0 1 2 2 2 
1 1 1 0 1 1 0 4 1 0 4 4 1 1 2 1 4 2 0 0 
5 0 0 0 1 1 1 1 1 4 1 1 5 1 2 5 0 2 0 5

19 9
0 9
6 7
15 9
12 9
2 1

