12 5  0 0 
0 2 2 2 0 2 2 2 2 2 0 5 
0 2 2 2 5 2 2 2 0 2 0 2 
0 2 0 2 2 2 2 2 5 2 2 2 
0 2 5 2 2 2 2 2 0 2 2 2 
5 3 2 2 2 2 2 2 2 2 2 2 
 
0 4 
8 2 
11 0 
4 1 
2 3