9 5  0 0 
0 0 0 0 0 0 0 0 0 
2 2 2 2 2 2 2 2 0 
0 6 6 6 6 6 6 6 0 
0 2 2 2 2 2 2 2 2 
0 0 0 0 0 0 0 0 3 
