15 15  7 7 
0 0 0 0 0 0 0 0 0 0 0 0 0 0 0  
0 0 0 0 2 n 0 0 0 0 2 n 0 0 0  
0 0 y 0 2 0 0 0 0 0 2 0 0 b 0  
0 0 0 0 2 0 0 0 0 0 2 0 0 0 0  
2 2 2 2 2 2 2 R 2 2 2 2 2 2 2  
s 1 1 1 2 0 0 0 0 0 2 S 6 S T  
1 1 1 1 2 0 0 0 0 0 2 6 6 w 6  
i 1 0 0 Y 0 g 0 r 0 B 0 6 6 U  
1 1 1 1 2 0 0 0 0 0 2 6 6 0 6  
1 1 1 1 2 0 0 0 0 0 2 V 6 6 U  
2 2 2 2 2 2 2 G 2 2 2 2 2 2 2  
0 0 0 0 2 0 0 0 0 0 2 0 0 0 0  
0 0 0 0 2 0 0 0 0 0 2 0 0 0 0  
0 0 0 0 2 0 0 0 0 0 2 0 0 0 0  
0 0 0 0 2 0 0 0 0 0 2 0 0 0 0  
