6 6  5 5 
3 0 6 6 S T  
0 0 6 6 6 6  
6 6 6 6 6 6  
6 6 6 6 6 6  
S 6 6 6 0 0  
V 6 6 6 i 0  
