25 25  0 24 
5 0 4 0 2 1 1 1 1 5 2 5 2 0 0 2 2 0 0 0 0 0 0 0 5 
4 0 4 4 1 1 1 1 1 1 2 6 2 4 0 2 0 0 4 2 2 2 2 2 2 
4 0 4 0 0 1 1 1 1 5 2 6 2 0 0 2 0 0 0 0 4 0 0 0 0 
4 0 4 4 0 1 1 1 1 2 2 6 2 4 0 2 2 0 0 4 2 4 2 0 0 
4 0 4 0 0 1 1 1 1 2 S U 2 0 0 0 2 2 0 0 4 0 2 0 0 
4 0 4 0 0 1 1 1 1 2 6 6 2 4 2 0 0 2 2 2 2 1 0 0 0 
0 0 0 0 0 0 0 0 0 0 V 6 2 0 0 2 0 0 0 0 0 0 2 2 2 
2 2 2 2 2 2 2 2 2 2 2 3 2 0 0 0 2 2 2 2 2 0 2 1 0 
2 0 2 2 0 0 0 0 0 0 2 2 2 0 0 0 0 0 0 0 2 0 2 1 6 
0 0 0 0 0 2 0 2 2 0 5 2 0 0 0 0 0 4 4 4 2 1 1 1 6 
0 2 0 2 2 2 2 0 0 2 0 2 0 0 0 6 6 6 6 6 6 1 1 1 6 
0 0 2 2 0 0 0 2 0 0 0 2 0 0 0 0 0 0 0 0 0 0 0 2 5 
0 2 0 0 0 2 0 0 0 2 0 2 2 2 2 2 2 2 2 2 2 2 2 2 2 
0 0 2 2 0 2 0 2 2 0 2 5 2 5 0 0 0 0 0 0 0 0 0 0 0 
0 0 0 2 0 2 0 0 0 2 0 0 2 4 2 2 2 2 2 2 2 2 2 2 4 
2 2 0 2 2 2 0 0 2 0 0 0 2 0 2 6 0 6 0 6 0 6 0 2 0 
0 0 0 0 0 2 0 2 1 4 1 2 2 0 2 2 6 2 6 2 6 2 6 2 0 
0 2 2 2 0 0 2 1 4 1 2 5 2 0 2 6 0 6 0 6 0 6 0 2 0 
0 0 2 0 0 2 0 4 1 2 0 0 2 0 2 2 6 2 6 2 6 2 6 2 0 
0 2 0 0 2 0 4 1 2 0 0 2 2 0 2 6 0 6 0 6 0 6 0 4 0 
2 0 0 2 0 0 2 2 0 0 2 5 2 0 0 0 6 2 6 2 6 4 0 4 0 
0 0 2 0 0 2 0 0 0 2 0 6 2 0 0 6 0 6 0 6 0 4 0 4 0 
i 2 0 0 2 0 0 2 2 0 0 6 2 0 2 2 6 2 6 2 6 4 0 4 0 
2 0 0 2 0 0 2 0 0 0 0 6 2 0 0 6 0 6 0 6 0 2 2 2 2 
0 0 2 0 0 4 1 0 6 6 6 U 2 2 6 2 6 2 0 0 1 1 1 1 5 

24 11 
13 13 
24 24 
11 20 
10 9 
9 2  
0 0 
11 17
9 0 
11 13 
24 0 
11 0