23 11  4 0 
1 4 1 4 0 2 1 4 1 4 5 2 5 1 1 1 5 2 1 4 1 4 1 
4 1 1 1 1 2 4 1 1 1 1 2 4 1 1 1 0 2 4 1 1 1 4
1 1 1 1 1 2 1 1 1 1 1 2 1 0 1 1 0 2 5 1 1 1 1 
4 1 1 1 1 2 4 1 1 1 1 2 1 4 1 4 1 2 1 1 1 1 4 
1 4 1 4 1 2 1 4 1 5 1 2 1 1 0 0 1 2 1 4 1 4 1 
1 1 1 1 4 2 4 1 1 1 1 2 1 1 4 1 1 2 4 1 1 1 1 
1 1 1 1 1 2 1 1 1 1 1 2 1 0 1 0 1 2 1 1 1 1 1 
1 1 1 1 4 2 4 1 1 1 1 2 1 4 1 4 1 2 0 1 1 1 1 
5 4 1 4 1 2 1 4 1 4 5 2 0 1 1 1 0 2 5 1 1 1 1 
1 1 1 1 1 2 1 1 1 1 1 2 0 1 1 1 0 2 1 1 1 1 1
1 1 1 1 1 2 5 1 1 1 1 2 5 1 1 1 5 2 5 3 1 1 1 
 
0 8 
6 10
18 2
16 0
10 8 
10 0 
9 4
18 10
12 0
16 10
12 10
18 8