15 15  6 6 
0 0 0 0 0 2 2 2 2 2 0 0 0 0 3  
0 0 0 0 0 2 5 2 5 2 0 0 0 0 0  
0 0 0 0 0 2 0 2 0 2 0 0 0 0 0  
0 0 0 0 0 2 0 2 0 2 0 0 0 0 0  
0 0 0 0 5 2 0 2 0 2 5 0 0 0 0  
2 2 2 2 2 2 Y 2 Y 2 2 2 2 2 2  
2 5 0 0 0 G 0 g 0 R 0 0 0 5 2  
2 2 2 2 2 2 y 5 r 2 2 2 2 2 2  
2 5 0 0 0 G 0 b 0 R 0 0 0 5 2  
2 2 2 2 2 2 B 2 B 2 2 2 2 2 2  
0 0 0 0 5 2 0 2 0 2 5 0 0 0 0  
0 0 0 0 0 2 0 2 0 2 0 0 0 0 0  
0 0 0 0 0 2 0 2 0 2 0 0 0 0 0  
0 0 0 0 0 2 5 2 5 2 0 0 0 0 0  
3 0 0 0 0 2 2 2 2 2 0 0 0 0 0  
 
7 7 
10 4 
1 6 
8 1 
4 4 
10 10 
1 8 
7 7 
7 7 
6 13 
13 6 
4 10 
7 7