5 5 0 0 
0 0 2 5 0 
5 0 2 0 0 
2 2 2 2 2 
0 0 2 5 0 
0 5 2 0 3 
 
1 4 
3 0 
0 1 
3 3