18 12  2 0 
0 4 5 4 0 2 5 0 0 0 0 2 0 4 1 1 1 5 
4 0 4 0 4 2 0 0 0 0 0 1 0 4 1 2 2 2 
5 4 2 4 5 2 0 0 2 2 2 2 1 1 1 0 0 0 
4 0 4 0 4 2 0 0 2 5 0 0 0 1 0 0 0 0 
0 4 5 4 1 2 0 0 2 0 0 0 0 4 0 0 0 0 
2 2 2 2 0 2 0 0 2 0 0 0 0 0 0 0 0 0 
0 0 0 0 0 2 0 0 2 2 2 2 2 2 2 2 2 2 
5 4 2 0 0 2 0 0 2 0 0 0 0 0 0 0 0 5 
0 0 2 0 0 2 0 0 2 0 0 0 0 4 4 4 0 0 
2 2 2 0 0 2 0 0 2 1 1 1 1 1 1 1 1 1 
0 5 2 0 0 0 0 0 2 1 1 1 1 1 1 1 1 1 
3 0 2 0 0 0 0 0 2 1 1 1 1 1 1 4 1 5 
 
2 4 
9 3 
17 7 
0 7 
2 0 
4 2 
4 2 
0 2 
17 0 
17 11 
1 10