11 11  3 5 
b 2 y 2 g 2 g 2 y 2 b  
0 2 0 2 0 2 0 2 0 2 0  
0 2 0 2 0 2 0 2 0 2 0  
Y 2 B 2 Y 2 Y 2 Y 2 Y  
y 2 0 0 0 2 0 0 0 2 0  
0 2 0 0 y 2 4 4 0 2 0  
0 Y 0 0 0 G 0 0 0 Y g  
Y 2 R 2 Y 2 0 2 Y 2 G  
0 2 0 2 0 2 1 2 0 2 0  
w 2 0 2 0 2 1 2 0 2 0  
r 2 y 2 b 2 y 2 b 2 3  
