20 14 19 0
1 0 0 0 0 0 0 0 0 0 0 0 0 0 0 0 0 0 0 0
0 1 0 0 0 0 4 0 0 0 0 0 0 0 0 0 0 0 0 0
0 0 2 2 2 2 2 2 2 2 2 2 2 2 2 2 2 2 2 2
0 0 2 0 0 0 0 0 0 0 0 0 0 0 0 0 0 0 0 0
0 0 2 0 0 0 0 0 0 0 0 0 0 0 0 0 0 0 0 0
0 0 2 0 0 2 2 2 2 2 2 2 2 2 2 2 2 2 0 0
0 0 2 0 0 2 3 0 0 0 0 0 0 0 0 0 0 2 0 0
0 0 2 0 0 2 0 0 0 0 0 0 0 0 0 0 0 2 0 0
0 0 2 0 0 2 2 2 2 2 2 2 2 2 2 0 0 2 0 0
0 0 2 0 0 0 0 0 0 0 0 0 0 0 0 0 0 2 0 0
0 0 2 0 0 0 0 0 0 0 0 0 0 0 0 0 0 2 0 0
0 4 2 2 2 2 2 2 2 2 2 2 2 2 2 2 2 2 n 0
0 0 0 0 0 0 0 0 0 0 0 0 0 0 0 0 0 0 0 0
0 0 0 0 0 0 0 0 0 0 0 0 0 0 0 0 0 0 0 0
