12 12  10 1 
2 6 6 6 6 6 6 1 6 6 6 T 
S 6 6 6 6 T 0 0 w 2 0 6 
6 0 0 0 0 6 2 2 2 2 0 6 
6 0 0 0 0 6 0 0 0 0 0 6 
6 0 0 4 0 4 0 0 0 0 0 6 
6 0 0 0 0 0 0 0 0 0 0 6 
6 0 0 0 0 0 0 0 0 0 0 6 
V 6 6 6 6 1 6 6 6 6 6 U 
2 2 2 2 2 1 2 2 2 2 2 2 
0 0 0 0 0 1 0 0 0 0 0 0 
0 0 0 0 0 0 0 0 0 0 0 0 
0 0 0 0 0 0 0 0 0 0 0 3 
