20 12  0 0 
0 6 6 6 6 6 5 2 1 1 1 1 1 1 1 2 0 0 0 5 
1 1 1 1 1 1 1 2 1 5 1 1 5 1 1 2 0 0 0 0 
1 1 1 1 1 1 1 2 1 4 1 1 1 1 1 2 2 2 2 2 
1 1 1 1 1 1 1 2 1 1 1 1 1 1 1 0 0 0 0 0 
1 1 1 1 1 1 1 2 0 0 0 0 0 0 0 0 2 0 2 0 
2 2 2 2 2 2 2 2 2 2 2 2 2 2 2 2 2 0 2 0 
0 2 2 0 0 0 2 0 2 0 0 2 4 0 4 0 0 0 2 0 
0 0 0 0 2 0 0 0 0 4 0 0 4 0 4 0 0 0 2 0 
2 2 0 2 2 2 2 2 0 0 2 0 4 2 0 2 2 2 2 0 
0 0 0 2 0 0 0 2 0 2 0 0 0 2 0 2 0 4 0 0 
0 2 2 5 0 2 0 2 2 2 2 2 0 0 0 2 0 0 2 2 
0 0 0 0 0 2 0 0 0 0 0 0 6 6 6 6 6 6 6 3 
 
9 1 
12 1 
6 0 
19 0 
19 0